R 600 400
NO ./textures/metal.xpm
SO ./textures/rainbow.xpm
WE ./textures/tiger.xpm
EA ./textures/wall.xpm
C 16747640
F 16737400
111111111100
10000S000001
100000000001
100000000001
111111111111